11111111
10P0E000
100C0001
10000001
11111111







