11111111111111111111111
10E00P00000000000000001
100C0100000000000000001
10000000000000000000001
11111111111111111111111

