11111111111111111111111
11E10P0000000000001C101
100C0000000000000000001
10000000000000000000001
11111111111111111111111
