11111111
1P000001
100C0001
10000001
11111111