11111111
1P000001
100C0001
10000lE1
11111111