111111111111111111111
100000000000000000001
100000000C00000000001
1P00000111110000001E1
111111111111111111111