11111111111111111111
1P000C00000000000001
1111111000000000C001
10000000000000111111
1C000000000000000001
11110000000000000C01
10CC0000000000011111
11111110000000000001
100C0000000000001E11
11111111111111111111