11111111111
1P0C0000CE1
10111111111
100C0M00C01
10110110111
100001C0001
101101M1011
10C000000C1
10110111101
10000000C01
10111111101
10000000001
11111111111