1111111111111111
1M000000P0000M01
1001111000001111
1000000001000001
1C00M0C00000C001
1000000001E10001
100000C001110001
1000000000000M01
100M00C0000C0001
1111111111111111