1111111
1P00C01
101M001
100C001
101M001
1E0C001
1111111