1111111111111111
1M000000P0000M01
1001111000001111
1000000001000001
1C00M0C00000C001
1000000000E00001
100000000C000001
1000000000000M01
100M000000000001
1111111111111111
