11111111111111111111111111111111111
1000000001100000000001C000000001011
10000000000000000000000000000000101
10000000000110000000110000000000101
1000000C000C00000000C00000000000101
10000000000011111111111100000001011
10000000000000000000000000000010101
10000000000000000000000000000000001
100000C00000000000000C0000000000001
10000000000000000000000000000000001
10000P00000000C00000000000001E10001
11111111111111111111111111111111111
11111111111111111111111111111111111
11111111111111111111111111111111111