1111111111111111
10000000P0000001
1001111000001111
100M000001000001
1C0000C00000C001
1000000000E00001
1M0000000CM00001
1000000000000001
100000M000000001
1111111111111111
